NO textures/stone.xpm
SO textures/yellow.xpm
WE textures/red.xpm
EA textures/green.xpm

F 255,0,255
C 0,255,255
11111111111111111111111111111111111111
100000000000000000D0000000000000111111
100M000000000011111110000000000000D001
10000000000000100000100000000000111001
100000000000001000M0100000000000111001
11110000000000D0000010000000001D101111
   1000001111111110111000000001000001
   1000001111000000111000000001100001
   1000001111001110011000000001110001
   100000111101111100D000000111111111
   100C00111100000001100000000C0C1111
   1C0000D0000111110010000C00C0011111
   1000001111011  11010000000000111111
   10C0001111011  110D0000000000000001
   1000001100011  1111000000W000000001
   1C00001101111  11110000000000000001
   100000110111111111100011111111D1111
   100000D0000000000000001C000000000C1
   11111111111111111111111111111111111