NO textures/stone.xpm
SO textures/yellow.xpm
WE textures/red.xpm
EA textures/green.xpm

F 255,0,255
C 0,255,255

1111111111111111111111111111111111111111111
111M0000000000000000000000000000000000111111111
11100000000000000000111111100000000000111111111
11100000000000000000100000100000000000111111111
11111111100000000000D000M0100000000000111111111
    11100000000000001000001000000000000111111111
    11100000000011101000001000000000000111111111
    1110000000001 10111D1110000000000111111111
    1110000000001 100000000000000000000C0C111111111
    1110000000001 110000000000000000C00C00111111111
    1110000000001 0000C000000000000000000111111111
    1110000000001 1110000000000000000000000000111111111
    1110000000001 1000000000000000000000000000111111111
    1110000000001111110000000N0000000000000000111111
    11100000000000000000000000000000000111111111
    111111111111111111111111111111111111