	F 		255,0,255
NO textures/stone.xpm
SO textures/yellow.xpm
EA textures/green.xpm
			WE 		textures/red.xpm

F 255,0,255
C 0,255,255


         1111111111111111111111111
         10000000001100000000001
         10110000011100000000001
         10010000000000000000001
11111111101100000111000001000001
100000000011000001110111000111111
111101111111110111000000101000001
11110111101111011101010000000001
11000000110101001100001D10101001
1000000000000000000000D0MC000001
100000000000000000C00010C000001
1000000000000000000000000C0000111111
100000000000000011010000N000000000001
110000011101010111110100000011111111
11110111 1110101 101111010001
11111111 11111111111111111111