				NO textures/stone.xpm
SO 		textures/yellow.xpm
WE 			textures/blue.xpm
			EA textures/pink.xpm

F 255,0,255
C 0,255,255
111111111111111111111111111111111111111111111111111111111111111111111111111111111111111111111111111111111111111111111111
1W0000000000000000000000000000000000000000000000000000000000000000000000000000000000000000000000000000000000000000000001
1000000000000000000000000N0000000000000000000000000000000000000000000000000000000000000000000000000000000000000000000001
110101010101010101010101010101010101010101010101010101010101001010101010101010101010101010101010101010101010101010101011
111111111111111111111111111111111111111111111111111111111111111111111111111111111111111111111111111111111111111111111111