NO textures/stone.xpm
SO textures/yellow.xpm
WE textures/red.xpm
EA textures/green.xpm

F 255,0,255
C 0,255,255

1111111111111111111111111111111111111111111111
111000000000000000000000D000000000000011111111
11100M0000000000000011111110000000000000D00111
1110000000000000000010000010000000000011100111
111000000000000000001000M010000000000011100111
11111111100000000000D0000010000000000011100111
    111000000000111111111011100000000111100111
    111000000000111100000011100000000111111111
    111000000000111101111001100000000111111111
    111000000000111101111100D00000011111111111
    111000000000111101111101100000000C0C111111
    111000000000D000011  10010000C00C001111111
    1110000C00001111011  110100000F000011111111111
    1110C00000001111011  110D000000000000000111111
    1110000000001100011  1111000000W00000000111111
    1110000000001101111  1111000000000000000111111
    111000000000110111111111100011111111D111111111
    111000000000D0000000000000001C000000000C111111
    1111111111111111111111111111111111111111111111
